NO assets/eagle.xpm
SO assets/eagle.xpm
WE assets/eagle.xpm
EA assets/eagle.xpm
F 220,0,80
C 255,255,233

1111111111
1000000001
1000000001
1000010001
1000010001
1011110001
1000000001
10000N0001
1000000001
1111111111