NO assets/eagle.xpm
SO assets/eagle.xpm
WE assets/eagle.xpm
EA assets/eagle.xpm
F 220,0,80
C 255,255,233

1111111111111111111111111111111111111111111111111111111111111111111111111111111111111111111111111111111111111
1000000000000000000000001100000000000000000000000000000000000000000000000000000000000000000111000000000000011
1000000000000000000000001100000000000000000000000000000000000000000000000000000000000000000111000000000000011
1000000000000000000000001100000000000000000000000000000000000000000000000000000000000000000111000000000000011
1000000000000000000000001100000000000000000000000000000000000000000000000000000000000000000111000000000000011
1000000000000000000000001100000000000000000000000000000000000000000000000000000000000000000111000000000000011
1000000000000000000000001100000000000000000000000000000000000000000000000000000000000000000111000000000000011
1000000000000000000000001100000000000000000000000000000000000000000000000000000000000000000111000000000000011
1000000000000000000000001100000000000000000000000000000000000000000000000000000000000000000111000000000000011
1000000000000000000000001100000000000000000000000000000000000000000000000000000000000000000111000000000000011
1000000000000000000000001100000000000000000000000000000000000000000000000000000000000000000111000000000000011
1000000000000000000000001100000000000000000000000000000000000000000000000000000000000000000111000000000000011
1000000000000000000000001100000000000000000000000000000000000000000000000000000000000000000111000000000000011
1111000000000001111111111111111110000000000001111110000000000001111111100000000001111111100000000000000001111
1111000000000001111111111111111110000000000001111110000000000001111111100000000001111111100000000000000001111
1111000000000001111111111111111110000000000001111110000000000001111111100000000001111111100000000000000001111
1111000000000001111111111111111110000000000001111110000000000001111111100000000001111111100000000000000001111
1111000000000001111111111111111110000000000001111110000000000001111111100000000001111111100000000000000001111
1111000000000001111111111111111110000000000001111110000000000001111111100000000001111111100000000000000001111
1111000000000001111111111111111110000000000001111110000000000001111111100000000001111111100000000000000001111
1111000000000001111111111111111110000000000001111110000000000001111111100000000001111111100000000000000001111
1111000000000001111111111111111110000000000001111110000000000001111111100000000001111111100000000000000001111
1111000000000001111111111111111110000000000001111110000000000001111111100000000001111111100000000000000001111
1111000000000001111111111111111110000000000001111110000000000001111111100000000001111111100000000000000001111
1111000000000001111111111111111110000000000001111110000000000001111111100000000001111111100000000000000001111
1111000000000001111111111111111110000000000001111110000000000001111111100000000001111111100000000000000001111
1100000000000000000000000000000000000000000000000000000000000000000000000000000000000000000000000000000000001
1100000000000000000000000000000000000000000000000000000000000000000000000000000000000000000000000000000000001
1100000000000000000000000000000000000000000000000000000000000000000000000000000000000000000000000000000000001
1100000000000000000000000000000000000000000000000000000000000000000000000000000000000000000000000000000000001
1100000000000000000000000000000000000000000000000000000000000000000000000000000000000000000000000000000000001
110000000000000000000000000000000000000000000000000000000000000000000000N000000000000000000000000000000000001
1100000000000000000000000000000000000000000000000000000000000000000000000000000000000000000000000000000000001
1100000000000000000000000000000000000000000000000000000000000000000000000000000000000000000000000000000000001
1111111111100000000000001111111111111110111111111100000000000000000000000000000000000000000000000000000000001
1111111111100000000000001111111111111110111111111100000000000000000000000000000000000000000000000000000000001
1111111111100000000000001111111111111110111111111100000000000000000000000000000000000000000000000000000000001
1111111111100000000000001111111111111110111111111100000000000000000000000000000000000000000000000000000000001
1111111111100000000000001111111111111110111111111100000000000000000000000000000000000000000000000000000000001
1000000000000000000000000000000000000000000000000000000000000000000000000000000000000000000000000000000000001
1000000000000000000000000000000000000000000000000000000000000000000000000000000000000000000000000000000000001
1000000000000000000000000001100000000000000000000000000000111111100000000000000000000000000000000000000000001
1000000000000000000000000001100000000000000000000000000000111111100000000000000000000000000000000000000000001
1000000000000000000000000001100000000000000000000000000000111111100000000000000000000000000000000000000000001
1000000000000000000000000001100000000000000000000000000000111111100000000000000000000000000000000000000000001
1000000000000000000000000001100000000000000000000000000000111111100000000000000000000000000000000000000000001
1000000000000000000000000001100000000000000000000000000000111111100000000000000000000000000000000000000000001
1000000000000000000000000001100000000000000000000000000000111111100000000000000000000000000000000000000000001
1000000000000000000000000000000000000000000000000000000000000000000000000000000000000000000000000000000000001
1000000000000000000000000000000000000000000000000000000000000000000000000000000000000000000000000000000000001
1000000000000000000000000000000000000000000000000000000000000000000000000000000000000000000000000000000000001
1000000000000000000000000000000000000000000000000000000000000000000000000000000000000000000000000000000000001
1000000000000000000000000000000000000000000000000000000000000000000000000000000000000000000000000000000000001
1000000000000000000000000000000000000000000000000000000000000000000000000000000000000000000000000000000000001
1111111111111111111111111111111111111111111111111111111111111111111111111111111111111111111111111111111111111