NO assets/Abs17.xpm
SO assets/Abs75.xpm
WE assets/Abs64.xpm
EA assets/Abs60.xpm

F 220,0,80
C 255,255,233


11111111111111111111111111111111111111111111111
11000000100010000010000111110000001100000000111
11100000101010000011000000110011000001111111111
10000001000010000100001100100001011000000001111
10000001010110000100010000100001011000000001111
10000001010110000100001000100001011000000001111
10000001010000000100001000100001011000000001111
10000001011111111100001111000111011000000001111
11110000000011000000000000011111110000000010001
11111100000000000000000000000000010000000000001
11000000111111111111111111111111111111111110001
10000000000000000001000000000000000000000000011
10000000000000000001000000000000000000000000001
10000000100000000001000000000000010000000000001
10000000100000000001111111111111110000000000001
10011111111111111111111111111111111111111111111
10000000000000000000000000000000000000000000001
10000000100000000001000000000000000001000000001
10000000100000000001000000000000000001000000001
10000000100000000001000000000000000001000000001
10000000100000000001000000000000000001000000001
10000000100000000001111111111111111111000000001
10000000100000000001000000000000000001000000001
10011111100000000001000000000000000001000000001
10000000000000000000000000000000000000000000001
10000000000000000000000000000000000000000000001
100000000000000000000000000000000000000000000N1
11111111111111111111111111111111111111111111111