NO assets/Abs17.xpm
SO assets/Abs75.xpm
WE assets/Abs64.xpm
EA assets/Abs60.xpm

F 220,0,80
C 255,255,233

1111111111111111111111111111111111111111111111111111111111111111111111111111111
1000000E01000000000000000000100000001000000000000000000000000000000000000000001
1000000001000000000000000000100000001000000000000000000000000000000000000000001
1001111111111110000111100000100100001000111111111111111111111001111001111111001
1001000001000000000100000000100100000000100000000000000100000001000001000001001
1000000001000000000100000000100100000000100000000000000100000001000001000001001
1000001001000011100100111111100111111111111111111110000100010001001001001001001
1001001001000010000100000000100100000000000000000010000000010001001000001001001
1001001111000010000100000000100100000000000000000010000000010000001000001001001
1111000001000011111111110000100100001000000000000011111111110000001111111001001
1000000001000010000100010000100100001000000000000000000000011111111000000001001
1000001001000010000100010000100100001000000000000000000000011111111000000001001
1001111001000010000100000000100100001001111111000011100000010000001000000001001
1000001000000010000100000000100000001001111111000011100000010000001000000001001
1000001000000010000100000000000000001001000001000010000000010000001000100001001
1000001111111110000100000000000000001001000001000010000000010000001000100001001
1000001000000010000111111111111111111001000001000010000000010000001000100001001
1111111000000010000111111111110000000001000001000000001000000000001000111111001
1000000000000010000000000000010000000001000001000000001000000000001000000001001
1000000000000010000000000000010001111111000001111110001000000010001000000001001
1000000000000011111111111000010001000000000001000000001000000010001000000001001
1000000000000010000000000000010001111111100001000001111001111110000000000001001
1000000000000010000000000000010000000000100001000010000000000010000000000001001
1000000000000010000000000000010000000000100001000010000000000011111111111111001
1000000000000010000111111111110001111000100001000011111111000010000000000000001
1000000000000010000100000000000001111000000001000000000001000010000000000000001
1000000000000010000100000000000001111000000001000000000001000010011111111111111
1000000000000010000100001111111111111001111111111111110001100010000000000000001
1000000000000010000100001000100000001001000000000000010001000010000000000000001
1000000000000010000100001000100000001001000000000000010001000011111111111000001
1000000000000010000000000000100010000001000000100010010001000000000000000000001
1000000000000010000000000000100010000001000000100010010001000000000000000000001
1111000011111111111111111111100011111001000000100010010001111111111111111100001
1000000000000000000000000000000010000000000000100010000000000000000000000000001
1000000000000000000000000000000010000000000000100010000000000000000000000000001
1111111111111111111111111111111111111111111111111111111111111111111111111111111
