NO assets/eagle.xpm
SO assets/eagle.xpm
WE assets/eagle.xpm
EA assets/eagle.xpm
F 220,0,80
C 255,255,233

111111111111111111111111111111111111111
100110011001100110011001100110011001101
110011001100110011001100110011001100111
111001100110011001100110011001100110011
110001100000111100001111000011110000111
110000111100011111000011110000111100111
100001100011011000011100011100011000001
100011000011000000011000000000011110001
110000000111000110011111000001110000001
110000001110000000001111100011110011001
111001110001000000011110000011100011001
111111100001110000111100011000000110001
11100111000111100011111001111N000000001
100000110000111000000000001100000000001
100000000000110000111000001110000000011
100000000001100000111100011111110000111
110000000011100000011100000111000001111
111000110000000111110000000111100000001
110000000000000111111111111110000000001
111111111111111111111111111111111111111
