NO assets/eagle.xpm
SO assets/eagle.xpm
WE assets/eagle.xpm
EA assets/eagle.xpm
F 220,0,80
C 255,255,233


11111111111111111111111111111111111111111111111
11000000101111111110000111110011101100000000111
11100000101111111110000111110011101100000000111
10000001011111111100001111100111011000000001111
10000001011111111100001111100111011000000001111
10000001011111111100001111100111011000000001111
10000001011111111100001111100111011000000001111
10000001011111111100001111100111011000000001111
11110000000011000000000000011111110000000010001
11111100000000000000000000000000000000000000001
11000000111111111111111111111111111111111111111
10000000000000000001000000000000000000000000011
10000000000000000001000000000000000000000000001
10000000100000000001000000000000010000000000001
10000000100000000001111111111111110000000000001
10000000100000000000000000000000000000000000001
11111111100000000000000000000000000000000000001
10000000100000000001000000000000000001000000001
10000000100000000001000000000000000001000000001
10000000100000000001000000000000000001000000001
10000000100000000001000000000000000001000000001
10000000100000000001111111111111111111000000001
10000000100000000001000000000000000001000000001
10011111100000000001000000000000000001000000001
10000000000000000000000000000000000000000000001
10000000000000000000000000000000000000000000001
100000000000000000000000000000000000000000000N1
11111111111111111111111111111111111111111111111

