NO assets/Abs17.xpm
SO assets/Abs60.xpm
WE assets/Abs64.xpm
EA assets/Abs75.xpm

F 145,255,175
C 124,124,255




11111111111111
1000000000001
1000000000001
1000000000001111111111111111111111111111111111111111111111111111111111111111111
1000000000000000000000000000000000000000000000000000000000000000000000000000001
1000000000000000000000000000000000000000000000000000000000000000000000000000001
1000000000001111111111111111111111111111111111111111111000000000000000000000001
1000000000001                                         1000000000000000000000001
1111111111111                                         1000000000000000000000001
                                                      1000000000111000000000001
                                                      1000000000111000000000001
                                                      1000000000111000000000001
                                                      1000000000111000000000001
                                                      1000000000111000000000001
                                                      1000110000111000111100001
                                                      1000110000111000111100001
                                                      1000111100000111110000001
                                                      1000111110000011100000001
                                                      1000001110000011110000001
    111111111111111111111111111111111111111111111111110000001110000011110000001
   1000000000000000000000000000000000000000000000011100000001110000011110000001
1111000000000000000000010000000000000000000000000000000000001110000011110000001
1111000000000000000000011111111111111111111111110000000000001110000011110000001
1111000000000000000000000000000000000000000000000000000000001110000011110000001
1111000000000001111111111111111111111111111111111100000000001110000011110000001
1111000000000000000000000000000000000000000000000000000000001110000011110000001
1111000000111111111111111111111111111111111111111100000000001110000011110000001
1111000000000000000000000000000000000000000000000111111111111100000000000000001
1100000000000000000000000000000000000000000000000000001000000000000000000000001
1100000000000000000000000100000000000000000000000000001000000000000000000000001
1100000000000000000000000100000000000000000S00000000001000000000000000000000001
1100000000000000000000000100000000000000000000000000001000000000000000000000001
1100000000000000000000000100000000000000000000000000001000000000000000000000001
1100000000000000000000000100000000000000000000000000001000000000000000000000001
1100000000000000000000000000000000000000000000000000001000000000000000000000001
1111111111111111111111111111111111111111111111111111111111111111111111111111111

